2
$
9
9
4
8
8
4
4
0
0
4
####/####
#.......#
#.......#
#..m.v..#
/......./
#....m..#
#..m....#
#.......#
####/####
%
1 m wall and 1 v vending machine
$
13
13
6
12
12
6
6
0
0
6
   ###/###
  #.......#
 #.........#
#...........#
#...........#
#...........#
/.........../
#...........#
#...........#
#...........#
 #.........#
  #.......#
   ###/###
$
