1
$
9
9
4
8
8
4
4
0
0
4
####/####
#.......#
#.......#
#..m.v..#
/......./
#....m..#
#..m....#
#.......#
####/####
%
1 m wall and 1 v vending machine
$
